

1111111
1000001
10000011
1000001
100N001
1111111