

1111111
1000001
1000001
1000001
100d001
1111111