

1111111111
1000000001
1000000001
1000000001
100N000001
1111111111