NO                                                  tamere

                    SO          t_image
    EA      wofweifn

    WE THOMAS

1111111111111111111111111111111
1000000000000000000000000000001
1000000010000000000000000000001
1000000000000000000000000000001
1000000000000000000000000011111
10000000000000N0000001000000001
100000000000000000000000000001
1000000000000100000000000000001
1000000000000000000000000000001
1000000000000100000000000000001
1000000000000000000000000000001
1000000000000000000000000000011
1000000000000000000000000000001
1000000000000000000000000000001
1000000000000000000000000000001
1000000000000000000000000000001
111111111111111111111111111111