


1111111111111111111111111111111
1000000000000000000000000000001
1000000000000000000000000000001
1000000000000000000000000000001
1000000000000000000000000011111
1000000000000000000000000000001
1000000000000000000000000000001
1000000000000000000000000000001
1000000000000000E00000000000001
1000000000000000000000000000001
1000000000000000000000000000001
1000000000000000000000000000011
1000000000000000000000000000001
1000000000000000000000000000001
1000000000000000000000000000001
1000000000000000000000000000001
111111111111111111111111111111