NO                                                  tamere

                    SO          t_image
    EA      wofweifn

1111111111111111111111111111111
1000000000000000000000000000001
10000000100000W0000000000000001
1000000000000000000000000000001
1000000000000000000000000011111
1000000000000000000001000000001
100000000000000000000000000001
1000000000000100000000000000001
1000000000000000000000000000001
1000000000000100000000000000001
1000000000000000000000000000001
1000000000000000000000000000011
1000000000000000000000000000001
1000000000000000000000000000001
1000000000000000000000000000001
1000000000000000000000000000001
111111111111111111111111111111